+---------+------+-------+--------------+--------+-------------------------------+
|         |      |       |              |        |                               |
|         |      |       |              |        |                               |
|         |      |       |              |        |                               |
+-----+   |      |       |              |        |    |                          |
|     |   |      |       |              |        |    |                          |
|     |   |      |       |              |        |    |                          |
|     |   |      |       |       |      |        |    +--------------------------+
|         |      |       |       |     -+        |                               |
|         |      +-----  |       |               |          |                    |
|         |              |       |               |          |                    |
|         +----------    |       |         ------+          |                    |
|                                |                          |           |        |
|                    +--------   |                          |           |        |
+-----------+        |           +-------------             |           |        |
|           |        |                                      |           |        |
|                    |                                      |           |        |
|       --------+    |                                      |           |        |
|               |    |            |                         |           |        |
|               |    |            |                  -------+           |        |
|               |    |            |                                     |        |
|               |    |            |                                     |        |
|               |    |            |                                     |        |
|               |    |            |                                     |        |
|               |    |            |                                     |        |
|               |    |            |                                     |        |
|               |    |            +----------                           |        |
|               |    |                                        ----------+        |
|               |    |                                                           |
+---------------+----+-----------------------------------------------------------+
