+---------+------+-------+--------------+--------+---------------------------------------------------------------------+-----------+-----------------------------------------------------------------+
|         |      |       |              |        |                                                                     |           |                  |                                              |
|         |      |       |              |        |                   |                                                 |     |     |    ....+                                      |                 |
|         |      |       |              |        |    +--------------+------                                           |     |     |        |               --------------         |                 |
+-----+   |              |     |        |        |    |              |                                 |               |     |     |        |                                                        |
|     |   |      |       |              |        |    |              |                                 |               |     |     +--------+                     |                                  |
|     |   |      |       |              |        |    |                                                |                     |                                                                       |
|     |   |      |       |       |      |        |    +----------------------------+-------------------+---------------------+-----------------+-----------------------------------------------------|
|         |      |       |       |     -+        |                                 |                                                           |                                                     |
|         |      +-------|       |               |          |                      |   -------------+                                          |                                                     |
|         |              |       |               |          |                      |                |                                          |                                                     |
|         +-------+              |     |   ------+          |           +-------  -+                |                 +------------------------+------------------+                                  |
|                 |              |                          |           |                                             |                                           |                                  |
|                 |  +--------   |                          |           |           ----------------+                 |                                           |                                  |
+-----------+     |  |           +-------------                         |                                             +------+                                    +----------------+                 |
|           |        |                                                  |                                                    |                |                                    |                 |
|                    |                                                  |                                                    |     |          |                                    +-+               |
|       --------+    |            +-------------------------+                      |           |                             |     |                     +-------------+             |               |
|               |    |--------    |                         |           |          |           +------------------           |     |                     |             |             |               |
|               |    |            |                  -------+           |          |                                         +-----+                     |             +-------------+               |
|     |         |    |            |                                     |          |                                                                     |                                           |
|               |    |            |                                     |          |       +----------                                                   |                                           |
|               |    |            |                                     +------    |       |                           |                 |               |                                           |
|--------       |    |     |      |            |                        |          |                                   |                 |               |                                           |
|               |    |            |                                     |          |           |                       |                 |               +------------------                         |
|               |    |---         |                                     |          |           +-----------------------+                 |                                                           |
|               |                 +----------                           |          |                                                                                                                 |
|         |     |    |                                        ----------+          |                                                                                                                 |
|               |    |                                                             |                                                                                                                 |
+---------------+----+-------------------------------------------------------------+-----------------------------------------------------------------------------------------------------------------+
