+---------+------+-------+--------------+--------+---------------------------------------------------------------------------------------------------------------------------------------------------+
|         |      |       |              |        |                                                                                                                                                   |
|         |      |       |              |        |                                                                                                                                                   |
|         |      |       |              |        |                                                                                                                                                   |
+-----+   |      |       |              |        |    |                                                                                                                                              |
|     |   |      |       |              |        |    |                                                                                                                                              |
|     |   |      |       |              |        |    |                                                                                                                                              |
|     |   |      |       |       |      |        |    +----------------------------------------------------------------------------------------------------------------------------------------------+
|         |      |       |       |     -+        |                                                                                                                                                   |
|         |      +-----  |       |               |          |                                                                                                                                        |
|         |              |       |               |          |                                                                                                                                        |
|         +----------    |       |         ------+          |                                                                                                                                        |
|                                |                          |           |                                                                                                                            |
|                    +--------   |                          |           |                                                                                                                            |
+-----------+        |           +-------------             |           |                                                                                                                            |
|           |        |                                      |           |                                                                                                                            |
|                    |                                      |           |                                                                                                                            |
|       --------+    |                                      |           |                                                                                                                            |
|               |    |            |                         |           |                                                                                                                            |
|               |    |            |                  -------+           |                                                                                                                            |
|               |    |            |                                     |                                                                                                                            |
|               |    |            |                                     |                                                                                                                            |
|               |    |            |                                     |                                                                                                                            |
|               |    |            |                                     |                                                                                                                            |
|               |    |            |                                     |                                                                                                                            |
|               |    |            |                                     |                                                                                                                            |
|               |    |            +----------                           |                                                                                                                            |
|               |    |                                        ----------+                                                                                                                            |
|               |    |                                                                                                                                                                               |
+---------------+----+-------------------------------------------------------------------------------------------------------------------------------------------------------------------------------+
